P P P P P P P P P P P P P
P - - - - - - - - - - - P
P - - - - - - - - - - - P
P - - P - - - - - P - - P
P - - - - - - - - - - - P
P - - - - - - - - - - - P
P P - - - P P P - - - P P
P - - 1 - - - - - 2 - - P
P - P P P - - - P P P - P
P - - - - - - - - - - - P
P - - - - - - - - - - - P
P P P P P P P P P P P P P